################################################################################
#                 #                                                            #
#                                                        ####                  #
#                                          p                                   #
#                                                                              #
#                                                                 #####        #
#                  ###                                                         #
#                                                                              #
#                                                                              #
#                     #                                                        #
#                     #                                                        #
#                     #              t                              #          #
#                                      ######                       #          #
#                                      ######                       #          #
#                                      ######                                  #
#                                                                              #
#                                                                              #
#                        #####                                                 #
#                        #####                                                 #
#                        #####                                                 #
#                                                                              #
#                                                               #####          #
#                                                               #####          #
#                                                               #####          #
#                                       ####                                   #
#           #                           ####                                   #
#           #                           ####                                   #
#           #                                                                  #
#           #                                                                  #
################################################################################